,,,Any,Rang,Homes,Dones,Total
,,,2002,00-04,216,230,446
,,,2002,05-09,270,252,522
,,,2002,10-14,270,274,544
,,,2002,15-19,324,280,604
,,,2002,20-24,433,373,806
,,,2002,25-29,465,417,882
,,,2002,30-34,433,406,839
,,,2002,35-39,454,439,893
,,,2002,40-44,400,384,784
,,,2002,45-49,346,296,642
,,,2002,50-54,292,274,566
,,,2002,55-59,270,263,533
,,,2002,60-64,281,263,544
,,,2002,65-69,342,329,671
,,,2002,70-74,249,307,556
,,,2002,75-79,195,230,425
,,,2002,80-84,87,175,262
,,,2002,>84,70,175,245
,,,2003,00-04,260,262,522
,,,2003,05-09,282,262,544
,,,2003,10-14,288,285,573
,,,2003,15-19,322,288,610
,,,2003,20-24,429,371,800
,,,2003,25-29,502,439,941
,,,2003,30-34,468,422,890
,,,2003,35-39,480,450,930
,,,2003,40-44,434,405,839
,,,2003,45-49,367,314,681
,,,2003,50-54,316,291,607
,,,2003,55-59,288,288,576
,,,2003,60-64,271,268,539
,,,2003,65-69,300,314,614
,,,2003,70-74,254,322,576
,,,2003,75-79,237,245,482
,,,2003,80-84,90,165,255
,,,2003,>84,63,168,231
,,,2004,00-04,306,296,602
,,,2004,05-09,294,272,566
,,,2004,10-14,306,296,602
,,,2004,15-19,317,296,613
,,,2004,20-24,423,367,790
,,,2004,25-29,541,462,1003
,,,2004,30-34,505,438,943
,,,2004,35-39,505,462,967
,,,2004,40-44,470,426,896
,,,2004,45-49,388,331,719
,,,2004,50-54,341,308,649
,,,2004,55-59,306,314,620
,,,2004,60-64,259,272,531
,,,2004,65-69,253,296,549
,,,2004,70-74,259,337,596
,,,2004,75-79,282,260,542
,,,2004,80-84,94,154,248
,,,2004,85~104,55,160,215
,,,2005,00-04,305,315,620
,,,2005,05-09,299,290,589
,,,2005,10-14,330,315,645
,,,2005,15-19,343,315,658
,,,2005,20-24,457,391,848
,,,2005,25-29,585,492,1077
,,,2005,30-34,578,504,1082
,,,2005,35-39,546,467,1013
,,,2005,40-44,521,492,1013
,,,2005,45-49,426,378,804
,,,2005,50-54,369,353,722
,,,2005,55-59,343,353,696
,,,2005,60-64,318,303,621
,,,2005,65-69,267,296,563
,,,2005,70-74,280,366,646
,,,2005,75-79,191,265,456
,,,2005,80-84,102,177,279
,,,2005,>84,51,177,228
,,,2006,00-04,374,311,685
,,,2006,05-09,374,352,726
,,,2006,10-14,374,311,685
,,,2006,15-19,388,338,726
,,,2006,20-24,471,406,877
,,,2006,25-29,651,527,1178
,,,2006,30-34,644,541,1185
,,,2006,35-39,609,500,1109
,,,2006,40-44,582,494,1076
,,,2006,45-49,499,433,932
,,,2006,50-54,402,379,781
,,,2006,55-59,374,392,766
,,,2006,60-64,346,311,657
,,,2006,65-69,305,311,616
,,,2006,70-74,277,352,629
,,,2006,75-79,222,271,493
,,,2006,80-84,125,189,314
,,,2006,>84,55,176,231
,,,2007,00-04,374,311,685
,,,2007,05-09,374,352,726
,,,2007,10-14,374,311,685
,,,2007,15-19,388,338,726
,,,2007,20-24,471,406,877
,,,2007,25-29,651,527,1178
,,,2007,30-34,644,541,1185
,,,2007,35-39,609,500,1109
,,,2007,40-44,582,494,1076
,,,2007,45-49,499,433,932
,,,2007,50-54,402,379,781
,,,2007,55-59,374,392,766
,,,2007,60-64,346,311,657
,,,2007,65-69,305,311,616
,,,2007,70-74,277,352,629
,,,2007,75-79,222,271,493
,,,2007,80-84,125,189,314
,,,2007,>84,55,176,231
,,,2008,00-04,361,320,681
,,,2008,05-09,346,334,680
,,,2008,10-14,354,320,674
,,,2008,15-19,346,390,736
,,,2008,20-24,447,557,1004
,,,2008,25-29,621,529,1150
,,,2008,30-34,686,557,1243
,,,2008,35-39,621,529,1150
,,,2008,40-44,505,488,993
,,,2008,45-49,534,516,1050
,,,2008,50-54,433,390,823
,,,2008,55-59,390,383,773
,,,2008,60-64,332,362,694
,,,2008,65-69,281,279,560
,,,2008,70-74,274,320,594
,,,2008,75-79,195,300,495
,,,2008,80-84,130,195,325
,,,2008,>84,87,181,268
,,,2009,00-04,378,331,709
,,,2009,05-09,360,342,702
,,,2009,10-14,356,328,684
,,,2009,15-19,363,366,729
,,,2009,20-24,417,474,891
,,,2009,25-29,525,492,1017
,,,2009,30-34,629,558,1187
,,,2009,35-39,647,544,1191
,,,2009,40-44,597,499,1096
,,,2009,45-49,575,502,1077
,,,2009,50-54,503,398,901
,,,2009,55-59,392,384,776
,,,2009,60-64,338,363,701
,,,2009,65-69,284,293,577
,,,2009,70-74,266,310,576
,,,2009,75-79,205,310,515
,,,2009,80-84,133,195,328
,,,2009,>84,133,195,328
,,,2010,00-04,394,342,736
,,,2010,05-09,373,349,722
,,,2010,10-14,358,335,693
,,,2010,15-19,380,342,722
,,,2010,20-24,387,391,778
,,,2010,25-29,430,454,884
,,,2010,30-34,573,559,1132
,,,2010,35-39,674,559,1233
,,,2010,40-44,688,510,1198
,,,2010,45-49,616,489,1105
,,,2010,50-54,573,405,978
,,,2010,55-59,394,384,778
,,,2010,60-64,344,363,707
,,,2010,65-69,287,307,594
,,,2010,70-74,258,300,558
,,,2010,75-79,215,321,536
,,,2010,80-84,136,196,332
,,,2010,>84,93,210,303
,,,2011,00-04,403,364,767
,,,2011,05-09,389,350,739
,,,2011,10-14,345,350,695
,,,2011,15-19,389,336,725
,,,2011,20-24,432,378,810
,,,2011,25-29,547,448,995
,,,2011,30-34,662,532,1194
,,,2011,35-39,691,560,1251
,,,2011,40-44,604,504,1108
,,,2011,45-49,576,490,1066
,,,2011,50-54,511,427,938
,,,2011,55-59,403,392,795
,,,2011,60-64,345,378,723
,,,2011,65-69,302,336,638
,,,2011,70-74,259,294,553
,,,2011,75-79,230,336,566
,,,2011,80-84,144,210,354
,,,2011,>84,72,168,240
,,,2012,00-04,355,364,719
,,,2012,05-09,355,336,691
,,,2012,10-14,320,336,656
,,,2012,15-19,398,343,741
,,,2012,20-24,398,364,762
,,,2012,25-29,462,511,973
,,,2012,30-34,639,546,1185
,,,2012,35-39,682,518,1200
,,,2012,40-44,611,490,1101
,,,2012,45-49,582,462,1044
,,,2012,50-54,511,532,1043
,,,2012,55-59,412,392,804
,,,2012,60-64,355,378,733
,,,2012,65-69,327,357,684
,,,2012,70-74,256,294,550
,,,2012,75-79,227,308,535
,,,2012,80-84,142,238,380
,,,2012,>84,107,196,303
,,,2013,00-04,376,319,695
,,,2013,05-09,376,361,737
,,,2013,10-14,348,347,695
,,,2013,15-19,369,312,681
,,,2013,20-24,404,347,751
,,,2013,25-29,445,361,806
,,,2013,30-34,626,485,1111
,,,2013,35-39,654,541,1195
,,,2013,40-44,585,527,1112
,,,2013,45-49,571,499,1070
,,,2013,50-54,508,465,973
,,,2013,55-59,404,388,792
,,,2013,60-64,348,374,722
,,,2013,65-69,313,347,660
,,,2013,70-74,264,291,555
,,,2013,75-79,209,305,514
,,,2013,80-84,139,277,416
,,,2013,>84,111,208,319
,,,2014,00-04,316,288,604
,,,2014,05-09,370,345,715
,,,2014,10-14,343,318,661
,,,2014,15-19,340,322,662
,,,2014,20-24,356,325,681
,,,2014,25-29,404,332,736
,,,2014,30-34,498,403,901
,,,2014,35-39,612,528,1140
,,,2014,40-44,612,511,1123
,,,2014,45-49,551,487,1038
,,,2014,50-54,508,464,972
,,,2014,55-59,404,393,797
,,,2014,60-64,350,372,722
,,,2014,65-69,316,345,661
,,,2014,70-74,262,308,570
,,,2014,75-79,195,288,483
,,,2014,80-84,175,281,456
,,,2014,>84,111,220,331
,,,2015,00-04,292,291,583
,,,2015,05-09,363,350,713
,,,2015,10-14,344,304,648
,,,2015,15-19,312,304,616
,,,2015,20-24,363,304,667
,,,2015,25-29,389,337,726
,,,2015,30-34,480,436,916
,,,2015,35-39,571,515,1086
,,,2015,40-44,571,528,1099
,,,2015,45-49,532,475,1007
,,,2015,50-54,506,475,981
,,,2015,55-59,402,396,798
,,,2015,60-64,351,370,721
,,,2015,65-69,318,343,661
,,,2015,70-74,260,324,584
,,,2015,75-79,182,271,453
,,,2015,80-84,156,284,440
,,,2015,>84,110,231,341
,,,2016,00-04,294,300,594
,,,2016,05-09,357,319,676
,,,2016,10-14,332,313,645
,,,2016,15-19,325,326,651
,,,2016,20-24,319,313,632
,,,2016,25-29,357,332,689
,,,2016,30-34,453,417,870
,,,2016,35-39,549,482,1031
,,,2016,40-44,536,508,1044
,,,2016,45-49,523,488,1011
,,,2016,50-54,485,495,980
,,,2016,55-59,408,417,825
,,,2016,60-64,345,365,710
,,,2016,65-69,306,352,658
,,,2016,70-74,243,313,556
,,,2016,75-79,179,274,453
,,,2016,80-84,153,287,440
,,,2016,>84,102,247,349
,,,2017,00-04,264,271,535
,,,2017,05-09,346,329,675
,,,2017,10-14,340,323,663
,,,2017,15-19,302,323,625
,,,2017,20-24,327,303,630
,,,2017,25-29,327,323,650
,,,2017,30-34,390,387,777
,,,2017,35-39,528,452,980
,,,2017,40-44,541,516,1057
,,,2017,45-49,541,400,941
,,,2017,50-54,491,362,853
,,,2017,55-59,428,374,802
,,,2017,60-64,352,284,636
,,,2017,65-69,314,271,585
,,,2017,70-74,252,284,536
,,,2017,75-79,189,219,408
,,,2017,80-84,164,181,345
,,,2017,>84,151,271,422
,,,2018,00-04,279,308,587
,,,2018,05-09,328,320,648
,,,2018,10-14,347,308,655
,,,2018,15-19,322,308,630
,,,2018,20-24,310,346,656
,,,2018,25-29,310,359,669
,,,2018,30-34,371,449,820
,,,2018,35-39,508,513,1021
,,,2018,40-44,520,474,994
,,,2018,45-49,532,487,1019
,,,2018,50-54,495,494,989
,,,2018,55-59,446,449,895
,,,2018,60-64,353,359,712
,,,2018,65-69,310,372,682
,,,2018,70-74,248,346,594
,,,2018,75-79,186,314,500
,,,2018,80-84,167,269,436
,,,2018,>84,149,205,354
,,,2019,00-04,260,270,530
,,,2019,05-09,297,321,618
,,,2019,10-14,347,334,681
,,,2019,15-19,335,308,643
,,,2019,20-24,297,321,618
,,,2019,25-29,291,359,650
,,,2019,30-34,347,411,758
,,,2019,35-39,458,488,946
,,,2019,40-44,508,475,983
,,,2019,45-49,520,488,1008
,,,2019,50-54,483,501,984
,,,2019,55-59,471,481,952
,,,2019,60-64,359,398,757
,,,2019,65-69,335,353,688
,,,2019,70-74,260,347,607
,,,2019,75-79,173,257,430
,,,2019,80-84,149,257,406
,,,2019,>84,161,321,482
,,,2020,00-04,260,270,530
,,,2020,05-09,297,321,618
,,,2020,10-14,347,334,681
,,,2020,15-19,335,308,643
,,,2020,20-24,297,321,618
,,,2020,25-29,291,359,650
,,,2020,30-34,347,411,758
,,,2020,35-39,458,488,946
,,,2020,40-44,508,475,983
,,,2020,45-49,520,488,1008
,,,2020,50-54,483,501,984
,,,2020,55-59,471,481,952
,,,2020,60-64,359,398,757
,,,2020,65-69,335,353,688
,,,2020,70-74,260,347,607
,,,2020,75-79,173,257,430
,,,2020,80-84,149,257,406
,,,2020,>84,148,307,455
,,,2021,00-04,260,270,530
,,,2021,05-09,297,321,618
,,,2021,10-14,347,334,681
,,,2021,15-19,335,308,643
,,,2021,20-24,297,321,618
,,,2021,25-29,291,359,650
,,,2021,30-34,347,411,758
,,,2021,35-39,458,488,946
,,,2021,40-44,508,475,983
,,,2021,45-49,520,488,1008
,,,2021,50-54,483,501,984
,,,2021,55-59,471,481,952
,,,2021,60-64,359,398,757
,,,2021,65-69,335,353,688
,,,2021,70-74,260,347,607
,,,2021,75-79,173,257,430
,,,2021,80-84,149,257,406
,,,2021,>84,148,345,493
,,,2022,00-04,247,499,746
,,,2022,05-09,284,243,527
,,,2022,10-14,333,294,627
,,,2022,15-19,321,320,641
,,,2022,20-24,308,294,602
,,,2022,25-29,284,301,585
,,,2022,30-34,296,294,590
,,,2022,35-39,382,320,702
,,,2022,40-44,506,396,902
,,,2022,45-49,506,473,979
,,,2022,50-54,506,499,1005
,,,2022,55-59,469,486,955
,,,2022,60-64,407,435,842
,,,2022,65-69,358,371,729
,,,2022,70-74,284,358,642
,,,2022,75-79,210,269,479
,,,2022,80-84,123,243,366
,,,2022,>84,99,230,329
